6 7
1 4 4 2 5 0 6
1 2 4 0 4 0 2
1 0 4 0 4 6 1
1 2 7 1 0 4 2
3 1 4 2 3 1 2
4 2 5 0 4 2 5
